11111111111111111
10111011111011101
10000000000000001
10111011011011101
10001001010010001
11101000000010111
11101011G11010111
1S00001G1110000D1
111010111G1010111
11101000000010111
10001001010010001
10111011011011101
10000000000000001
10111011111011101
11111111111111111